12 12
1 1 1 1 1 1 1 1 1 1 1 1
1 10 2 0 0 31 1 1 0 0 32 1
1 0 0 0 21 1 0 1 1 0 0 1
1 1 1 1 1 0 1 0 23 14 0 1
1 0 33 0 1 0 1 0 11 0 0 1
1 0 13 25 1 0 1 1 0 1 0 1
1 0 1 0 1 0 1 0 0 9 0 1
1 0 34 0 1 7 1 12 0 1 0 4
1 0 0 0 0 0 1 24 0 0 0 1
1 0 20 0 1 0 1 0 0 1 30 1
1 9 0 0 1 0 1 0 0 22 0 1
1 1 1 1 1 1 1 1 1 1 1 1